############
#          #
#    #     #
#    #     #
#    #     #
#    #     #
#  @ #     #
############