############
#          #
#    #     #
#    #     #
#    #     #
#    #     #
#  @ #     
############