############
#          #
#    #     #
#    #     #
#    #     #
#    #     #
#  @        
############